ReptonReturnsLevelV2
Level 1
-1
30,30
525255255555555555555555559000
6d1d13d12555522222222222256000
6d0k0a000455600000000a00k46000
58900a0004556000000000a0046000
604aaa000455600000m0000a046000
60100m000455600000000000a46000
600000000455600000000000046000
588888907555600000000000046000
555555604555590788888888856000
555555604555560452222222223000
255555604555560460000000000000
d45555604555560460078888890000
045555604555560458852222560000
012555601222230122260000158900
00d455600s000000rrr30000a15600
078555607888907seeee0m00ab4600
0122223045556s4888890000a75600
d00re0004555604555560000752300
8889e7904555604555558888560000
222225604555604555552222230000
000004604222304225560000000000
0000046i40eer01rr2560000000000
00000455604e7e0ee0460000000000
000001256045555560460000000000
00000004601222223k460000000000
000000046000d0d000460000000000
000000045888888888560000000000
000000012222222222230000000000
000000000000000000000000000000
000000000000000000000000000000
0
0
False
